Ubx	KEYWORD1
Fix	KEYWORD1
FIX_NONE	LITERAL1
FIX_2D	LITERAL1
FIX_3D	LITERAL1
FIX_DGNSS	LITERAL1
FIX_RTK_FLOAT	LITERAL1
FIX_RTK_FIXED	LITERAL1
DynMdl	KEYWORD1
DYN_MDL_PORTABLE	LITERAL1
DYN_MDL_STATIONARY	LITERAL1
DYN_MDL_PEDESTRIAN	LITERAL1
DYN_MDL_AUTOMOTIVE	LITERAL1
DYN_MDL_SEA	LITERAL1
DYN_MDL_AIRBORNE_1G	LITERAL1
DYN_MDL_AIRBORNE_2G	LITERAL1
DYN_MDL_AIRBORNE_4G	LITERAL1
DYN_MDL_WRIST	LITERAL1
DYN_MDL_BIKE	LITERAL1
AutoBegin	KEYWORD2
Read	KEYWORD2
SetDynModel	KEYWORD2
Begin	KEYWORD2
SetFactoryDefaults	KEYWORD2
SetRate	KEYWORD2
TestComms	KEYWORD2
AutoBaud	KEYWORD2
SetBaud	KEYWORD2
ConfigPort	KEYWORD2
EnableMsgs	KEYWORD2
fix	KEYWORD2
num_sv	KEYWORD2
utc_year	KEYWORD2
utc_month	KEYWORD2
utc_day	KEYWORD2
utc_hour	KEYWORD2
utc_min	KEYWORD2
utc_sec	KEYWORD2
utc_nano	KEYWORD2
gps_tow_s	KEYWORD2
gps_week	KEYWORD2
leap_s	KEYWORD2
time_acc_ns	KEYWORD2
ned_vel_mps	KEYWORD2
north_vel_mps	KEYWORD2
east_vel_mps	KEYWORD2
down_vel_mps	KEYWORD2
gnd_spd_mps	KEYWORD2
ecef_vel_mps	KEYWORD2
ecef_vel_x_mps	KEYWORD2
ecef_vel_y_mps	KEYWORD2
ecef_vel_z_mps	KEYWORD2
spd_acc_mps	KEYWORD2
track_deg	KEYWORD2
track_rad	KEYWORD2
track_acc_deg	KEYWORD2
track_acc_rad	KEYWORD2
llh_deg_m	KEYWORD2
llh_rad_m	KEYWORD2
lat_deg	KEYWORD2
lat_rad	KEYWORD2
lon_deg	KEYWORD2
lon_rad	KEYWORD2
alt_wgs84_m	KEYWORD2
alt_msl_m	KEYWORD2
horz_acc_m	KEYWORD2
vert_acc_m	KEYWORD2
ecef_pos_m	KEYWORD2
ecef_pos_x_m	KEYWORD2
ecef_pos_y_m	KEYWORD2
ecef_pos_z_m	KEYWORD2
ecef_pos_acc_m	KEYWORD2
gdop	KEYWORD2
pdop	KEYWORD2
tdop	KEYWORD2
vdop	KEYWORD2
hdop	KEYWORD2
ndop	KEYWORD2
edop	KEYWORD2